11 6 6 6 6 6 6 6 6 6 4 
9 14 14 14 14 14 14 14 14 14 9 
9 14 14 14 14 14 14 14 14 14 9 
9 14 14 14 14 14 14 14 14 14 9 
9 14 14 14 13 14 14 14 14 14 9 
9 14 14 14 14 14 13 14 14 14 9 
9 14 14 13 14 14 14 14 14 14 9 
9 14 14 14 14 14 13 14 14 14 9 
9 14 14 14 14 14 14 14 14 14 9 
9 14 14 14 14 13 14 14 14 14 9 
9 14 14 14 14 14 14 14 14 14 9 
9 14 14 13 14 14 14 13 14 14 9 
9 14 14 14 14 14 14 14 14 14 9 
9 14 14 14 14 14 14 14 14 14 9 
10 6 6 6 6 6 6 6 6 6 3 
